NO ./pictures/bluestone.xpm
SO ./pictures/bluestone.xpm
WE ./pictures/bluestone.xpm
EA ./pictures/bluestone.xpm

F 255,140,0
C 0,154,205

111111111111111111
101000000100000011
101000000000000001
1100N0000010000001
111111111111111111
