NO ./map1.cub
SO ./map1.cub
WE ./map1.cub
EA ./map1.cub

F 220,100,0
C 225,30,0

        1111111111111111111111111
        1000000000110000000000001
        1011000001110000000000001
        1001000000000000000000001
111111111011000001110000000000001
100000000011000001110111111111111
11110111111111011100000010001
11110111111111101010100100011
10000001101010111100000000011
10000000000000000100000010001
10000000000001001001010010001
1100000111010101111101110E00111
11110111 1110111 100111010001
11111111 1111111 11111111111




